{
  "levelId": 1,
  "levelName": "Test Level",
  "tileSize": 32,
  "width": 10,
  "height": 6,

  "spawn": { "x": 0, "y": 4 },

  "tiles": [
    [0,0,0,0,0,0,0,0,0,0],
    [0,0,0,0,0,0,0,0,0,0],
    [0,0,0,0,0,0,0,0,0,0],
    [0,0,0,0,0,0,0,0,0,0],
    [0,0,0,0,2,0,0,0,4,0],
    [1,1,1,1,1,1,1,1,1,1]
  ]
}
